c.....*
*****.*
*e***.*
*.***.*
*.....*
*******