******
***..*
e....*
*.****
*....*
*c*..*
******
