..***.**..
.*........
.*c****.*.
.***..*.*.
....***.*.
...e....*.
....*****.
........*.
