**********
**.......*
..........
...*......
...*.e....
...*......
...*..*...
..c*....*.
..*.......
..........
